R 1920 1080
NO ./img/bluestone128.xpm
SO ./img/wood.xpm
WE ./img/colorstone.xpm
WE ./img/bluestone.xpm
EA ./img/greystone.xpm

S ./img/barrel.xpm

F 102,102,102
C 51,51,51

        1111111111111111111111111
        1000000000110000000000001
        10110000011100000020000011111111111
        10010000000000E00000000000000100001   1 
1111111110110000011100000000000011111102201
100000000011000001110111111111111    100001
11110111111111011100000010001        100001
11110111111111011101010010001        100001  
11000000110101011100000010001        111111
10002000000000000000000000001
10000000000000001101010010001
1100000111010101111101111000111
11110111 1110101 101111010001
11111111 1111111 111111111111
