R 1920 1080
NO ./img/bluestone128.xpm
SO ./img/wood.xpm
WE ./img/colorstone.xpm
WE ./img/bluestone.xpm
EA ./img/greystone.xpm

S ./img/barrel2.xpm
S ./img/knight.xpm

F 102,102,102
C 51,51,51

        1111111111111111111111111
        1000000000110000000000001
        10110000011100000200020011111111111
        10010000000000N0000000000000000000111111111  1 
111111111011000001110000000000001111110220000000001
100000000011000001110111111111111    10002222222001
11110111111111011100000010001        10002222222001
11110111111111011101010010001        10002222222001  
11000000110101011100000010001        10002222222001
10002000000000000000000000001        10002222222001 
10000000000000001101010010001        10002222222001
1100000111010101111101111000111      100000000000011
11110111 1110101 101111010001        11111111111111
11111111 1111111 111111111111
