R 1920 1080
SO ./img/redbrick.xpm
NO ./img/bluestone128.xpm
WE ./img/bluestone.xpm
EA ./img/greystone.xpm

S ./img/Footman_Lordaeron.xpm

F 102,102,102
C 51,51,51

        1111111111111111111111111
        1000000000110000000000001
        10110000011100000200020011111111111
        10012000000000E0000000000000000000111111111  1
1111111110110000011100000000000011111100000000000011111111111111111111111
100000000011000001110111111111111    100222222220000000000000000000000001
11110111111111011100000010001        100222222220000000000000000000000001
11110111111111011101010010001        100222222220000000000000000000000001      11111111111
11000000110101011100000010001        100222222220000000000000000000000001      10020020001 
10002000000000000000000000001        100222222220000000000000000000000001      10200200001 
10000000000000001101010010001        100222222220000000000000000000000001      11111111111
1100000111010101111101111000111      100000000000011111111111111111111111      
11110111 1110101 101111010001        11111111111111
11111111 1111111 111111111111
